GGGGGGGGGGRRGGGGGCGCCGGGGGGGGGGGGGGGGGGGGGGCCCCGBBBGBBGGGGGGGCCCCGGGGGGGGGGGCGCCGGGGGGGGGGGGGGGGGGGG
GGGGGGGGGGGRGBBGBGCCCGGGGGGGGRRGGGGGGGGGGGCCGCCGBBBBBBBGGGCGCCCCCGGGGGGGGGGGCCCCCGGGGGGGGGGGGGGGGGGG
GGGGGGGGGGRGBBGGBCGCCCGGGGGGGGGRGGGGGGBBGBCCCBCGBBBGGBGGGGCGCCCCCCGGGGGGGGGGGCCCCGGGGGGGGGGGGGGGGGGG
GGGGGGGGRRGGBGBGBCCRCGGGGGGGGGRGCGGGCGGBGBCGCBCBBGBBBBBGGGGCCCCGCGGGGGGGGGGGCCCGCGGGGGGGGGGGGGGGGGGG
GGGGGGGRGGGGBBBBGRGRGGGGGGGGGGGGCCCCCGBBBBBGGGGBBGBBBBGGGGGCCCCCCCGGGGGGGGGGGGGGGGGGGGGGGGGGGGGGGGGG
RRGGGGGGRRGGBBBBBRRGGGGGGGGGCGCGCCCCCGGBGBBGGRGGGGGGGGGGGRCCCCCBGGGGGRRGGGGGGGGGGGGGGGGGGGGGGGGGGGGG
RRCCCGCGGGGGGGGGRGGGGGGGGGGGCCCCCGCGCGBGBBBGGGGGGGGGGGGGGRRBGGBGGGGGGGRGGGGGGRGRGGGGGGGGGGGGGGGGGGGG
GRCGCGCGGGCCCGCRGRGGGGGGGGGGCCGCCCGCRGGGGGGGGGGGGGGGGGGGGGGBBGBBGGGGRRGGGGGGGGRRRGGGGGGGGGGGGGGGGGGG
GGCGCCGGBBBBGCCGGGGGGGGGGGGGCCGCCBBBGGGGGGGGGGGGGGGGGGGGGGGGBBBGGCCCGCGGGGGGGRRGGGGGGGGGGGGCCCCCGGGG
GGCCCCBBBGCCCCCGGGGGGGGGGGGGCCCBCBBBGGGGGGGRGGGGGGGGGGGGGGGBBGBBGGCCCCGGGGGGGGGRRGGGGGGGGGBCBCCCGGGG
GGCCGCBBGBBCCCCGGGGGGGGGGGGGGGGBGBBCGCCGGGGGRGGGGGGGGGGGGGGGGGGGGCCCGCGGGGGGGGGGGGGGGGGGGGBGCCCCGGGG
GGGGBBBBBGCCGCCGGGGGGGGGGGGGGGGGBBBCCCCCCGGGGGGGGGGGGGGGGGGGGGGGGGCCCCCCCGGGGGGGGGGGGGGGGGBCBCCCBBGG
GCCGCCGBBBBBGGGGGGGGGGGGGGGGGGGBGBBBCCCCCGGGGGGGGGGGGGGGGGGGGGGGGCCCCCCCCGGGGGGGCGGCCGGGGGBCCCCCBBBG
GGCGCCBBGGGGGGGGGGGGGGGGGGGGGGGGGGCGCCGCGGGGGGGGGGGGGGGGGGGGGGGGGGGGCGCGCGGGGGGGCCCGGGGGGGGBBCCCBBBB
GCGCCCGGCGGGGGGGGGGRGGGGGGGGGGCGCCCCCCCCCGGGGGGGRGGGGGGGGGGGGGGGGGGGCGCCCGGGGGGGCCCGCGGGBGBGGCCGBBBB
GCGCGCGCGGGGGGGGGGRRGGGGGGGGGGGGGCGGGCCCGGGGGGGGGGRGGGGGGGGGGGGGGGGGCGCCGGGGGGGGGGCCCGGGBBBBBCCBBGBB
GGCCCCCCGBGBBBGGGGGGRGGGGGGGGGCCGCCGGGGGGGGGGGGGGGGGGGGGGGGGGGBBBBBGGGGGGGGGGGGGCGCCGGGGBBBBBGGGGGGG
GGGGCCCCCBBGGGGGGGGGGGGGRRGGGGCCCGGGGGGGGGGGGGGGGGGGGGGGGGRGGGBBBBBGGGGBBGGBBBGBGGCCCGCGGGBBBGGGGGGG
GGGGCCCCCBBGGBGGGGGGGGGGGGRGGGGCGCCGGGGGGGGGGGGGGGGGGGGGGGGGGGGGBGGGGGGGBBGBBBBBGGGCCCCGBBGBBGGGGGGG
GGGGGGBBBBGGGGGGGGGGRGRGBBBGGGGGGGGGGGGGGGGGGGGGGGGGGGGGGGGGGGBBBBGGGGGGBBBBBBBBGGCCCCCGGGGGGGGGGGGG
GGGGGBBBBBBGBBGGGGGGGRRGGBBBBGGGGGGGGGGGGGGGGGGRGRGGGGGGGGGGGGBGBBBGGGGBBBBBGBBBGGCGGCGGGGGGGGGGGGGG
GGGGGBBBBGGGGGGGGGGGGGBBBBBBBGGGGGGGGGGGGGGGGGGGGGGGGGGBGGBGGGGGGGGGGGGBGBGBBGBGGGCCGCGGGGGGGGGGGGGG
GGGGGGGGGGGGGGBGGBGGBBBGBBBGBGGGGGGGGGGGGGGGGGGGGGGGGGGBBGBGGGGGGGGGGGGGGGGRRGGGGGGGGGGGGGGGGGGGGGGG
GGGGGGGGGGGGGGGBBBGGBBBBBBBGBGGGGGGGGGGGGGGGGGGGGGGRRGGBBGBBGGGGGGGGGGGGGGGGGGGGGGGGGGGGGGGGGGGGBGBB
GGGGGGGGGGGGGBBBBGGGBBBBBGGGGGGGGGGGGGGGGGGGGGGGGGGGRGGGBGGGGGGGGGGGGGGGGGGGRRGGGGGGGGGGGGGGGGGGBBBG
GGGRGRGGGGGGGBBBBGBGBGGGBGBBCCCCCGGGGGGGGGGGCCGCCGGGRGGBBBWWGGGGGGGGGGGGGGBBBGGGGGGGGGGGGGGGGGGGGBBG
GGGRRGGGGGGGGGBBBGBGGGGGBBBGCCCCCGGGGGGGGGGGGCGCGCCCCCGGGWGGGWGWGGGGGGGGBBBGGGGGGGGGGGGGGGGGGGGGBGBB
GGGGBBBBGGGGGGBBGBGGGGGGBBBBBCCCGGGGGGGGGGGGGCCCCCCCWCWGWWGGWGGWWWGGWGGGBBGBGGGGGGGGGGGGGGGGGGGGGBBG
GGGBBBBGGGGGGGBGGBGGGGGGBBBBCCCGGGGGGGGGGGGGCCCCGCCCCGCWWWWWWWWWWWWGGGGGBBGBGGGGGGGGGGGGGGGGGGCCBBBB
GGGBBBGBGGGGGGGGGGGGGGGGBBBBCCCCGGGGGGGGGGGGCGCCCCCWWWWWWWWWWWWWWWWWWGGRGBGBBGGGGGGGGGGGGGGGGGGCBBCB
GGGBBBBBGBGGGGGGGGGGGGGGGBBBGGGGGGGGRRGGGGGGGGGGCCGCWWWWWWWWWWWWWWWGWGWWGGGGGGGGGGGGGGGGGGGGGGCCCBCG
GGGGGBGBBBBGGGGGGGGGGGGGGBBBBGGGGGGGGGGGGGGGGGGGWGGGWWWWWWWWWWWWWWWWWWWWRGRGGGGGGGGGGGGGGGGGGGCCBBBG
GGGGGGBBBGBGGGGGGGGGGGGGGGGGCCCCCGGRRGGGGGGGGBBBBGWGWWWWWWWWWWWWWWWWWWWGGGGRGGGGGGGGGGGGGGGGGGGCCCBB
GGGGGGGBBBBGGGGGGGGGGGGGGGGGGCCCCGGGGGGGGGGGGBGBWWGWWWWWWWWWWWWWWWWWWWGWGGGRGBBGBGGGGGGGBBBBBGGGGGGG
GGGGGGBBBBBGGGGGGGGGGGGGGGGGCGCCCGGGGGGGGGRGRBBGWBGWWWWWWWWWWWWWWWWWWWGWWGRGBBBBGGGGGGGGGBBBBGGGGGGG
GGGGGGGGGGGGGGGGGGGGGGGGGGGGCGGGCGGGGGGGGGRGGBBBWWWWWWWWWWWWWWWWWWWWWWWGWGRRBBGBBGGGGGGGBBBGBGGRRGGG
GGGGGGGGGGGGGGGGGGGGRGGGGGGGCCGGCGGCCGCCGGRGGGBBGWWWWWWWWWWWWWWWWWWWWWWWGGGGBBGBBGGGGGGGBBGGBGGGGGGG
GGGGGGGGGGGGGGGGGGGGGGGGGGGGGGGGGGGCCGGGGGGGGGGGGWWWWWWWWWWWWWWWWWWWWWWWWGGGBBBGBGGGGGGGBGBGBGGRRGGG
GGGGGGGGGGGGGGGGGGGGGGCCCCCGGGGBBBBGCCCCBBGGGGGGWGGWWWWWWWWWWWWWWWWWWWWWWWGGRGGGGGGGGGGGGGGGGGGGGGGG
GBCCCGGGGGGGGGGGGGGGGGCGCCCGGGGBGBBCGCCCBBBGGGGGWWWWWWWWWWWWWWWWWWWWWWWGWGGRCCCCGGGGGGGGGGGRGGGGGGGG
GGCCBCGGGGGGGGGGGGGGGGCCCCGGGGGBBBBCCCGCGBRBGGGGGWWWWWWWWWWWWWWWWWWWWWWWWGGGCCCCCGGGGGGGGGGGGGGGGGGG
GCCGCCGGGGGGGGGGGGGGGGCCCGGGGGGBBBGGGGGBBGBBGGGWWGWWWWWWWWWWWWWWWWWWWWWWWGGGCCCCGGGGGGGGGGGRGGGGGGGG
GGCBCCGGGGGRGGGGRRGGGGCGCCGGGGGBGBBBGGGGBBBBGGGGWGWWWWWWWWWWWWWWWWWWWWWGGGGGCCGCCGGGGGGGGGGGGGGGGGGG
GBBCCBGGGGRRGGGGGGRGGGGGGGGGGGGGGGGRGGGGGGGGGGGGGWWWWWWWWWWWWWWWWWWWWWWGGWGGCGGCCGGGGGGGGGGGGGGGGGGG
GGGGGGGGGGRRGGGGGRGGGGGGGGGGGGGGCCRGCGGGGGGGGGGGGWGWWWWWWWWWWWWWWWWWGWWGGGGGGGGGGGGGGGGGGGGGGGGGGGGG
GGGGGGGGGGGGGGBBBBGGGGGGGGGGGGGGCCCCCGGGGGGGGGGGWGGWWWWWWWWWWWWWWWWWWWGGWGGGGGGGGGGGGGGGGGGGGGGGGGGG
GGGGGGGGCCCCCGBGBGGGGGGGGGGGGGGGCCGCCGGGGGGGGGGGGRGWWWWWWWWWWWWWWWWWWGWWGGGGGGGGGGGGGGGGGGGGGGCCCGCG
GGBBBGGGGCCCGBBGGBGGGGGGGGGGGGGGCCRGCGGGGGGGGGGGGGRWGWWWWWWWWWWWWWWGGWGGGGGGGGGGGGGGGGGGGGGGGGCCCCCG
GBGGGBGGGCGCGBGBGBGGGBBBBBGGGGGGCGCCCGGGGGGGGGGGGGGGWGGGWGWWWWWWWWGWWGGGGGGGGGGGGGGGGGGGGGGGGGGGGCCG
GGBGBBGGCCCCCBBBGBRGGGGBBBGGGGGGGCCCCCGGGGGGGGGGGCGCCGWWWWGWWGWGGGWGWGGGGGGGGGGGGGGGGGGGGGGGGGCCCCCG
GBGBBBGGCCCGCCCGCGRGGBBGBGGGGGGGGCGGCGGGGGGCGGCCCCCCCWGGGGGGWGWRWRWGGGGGGGGGGGGGGGGGGGGGGGGGGGCGCCGG
GBBBBGGGGRGGGCCCGCGGGBBBBBGGGGGGGGGGGCGGGGGCGGCCGCCCGGGGGGGWGWGGRWGGGGGGGGRGGGGGGGGGGGGGGGGGGBGBBBGG
GGGGGGGGRGGGRCCCGCGGGBBBGBGGGGGGGCCCCGGGGGGGCCGCCCCCGGGGGGGGGGGRGGGGGGGGGGGGGGGGGGGGGGGGGGGGGBBGBGGG
GGCGCCCGGGRGRGGGGGGGGGGGGGGGGGGGGCCGCCGGGGGCCGCCGCCGCGGGGGGGGGGGGGGGGGGGGGGGGRGGGGGGGGGGGGGGGBBGBBGG
GGCCGCCGGGGGGGBBBBGGGGGGGGGGGGGGGGGGGGGGGGGGGCCGGGGGGGGGGGGGGGGGGGGGBBBGBGGGGGRGGGGGGGGGGGGGGBGGGGGG
GGCCCCCGCCCGGGBGBBBBGBGBGCGGCCGGGGGGGGGGGGGGGGGGGGGGGGGGGGGGGGGGGBGBBBBBBGGGGGGGBBGGGGGRRGGGGGGBGBGG
GGCCCGCCCCCGGGBBBBBGBBBBGCCCCCGGGGGGGGGGGGGGGGGGGGGGGGGGGGGGGGGGGGBBBBBGBGGGGGGGBBCCBGCGGRCCGCCGGGGG
GGGCCCCCGCCGGGGBGGBBBBGBGCGGCCGGGGGGGGGGGGGGGGGGGGGGGGGGGGGGGGGGGGGBBBBBBGBBBGGGBGGGCCCGRRCCCGCGGGGG
GGGGGGCCCCCGBBBBBGBGBBBBGGCCGCGGGGGGGGGGGGGBGBGGGGGGGGGGGGGGRGGGGBGBBBBGBBBGGGGGBBCCBCCGGGCCCCGGGGGG
GGGGGGCCCCCGBGBBBGGBBGBBGCCGCCGGGGBBGBBGGGGGBBBBGGGGGGGGGGGGGGGGGGGBBBGGBBBBBGGGBBCCRCGGGGGCCCCGGGGG
GGGGGBGGGGGGGBGBBGGGGGGGGGGGGGGGGGBBBGGGGGGGBBBBGGGGGGGGGGGRGRGGGGGCCGGGBBBGGGGGGGCCCGCGGGGGCCGGGGGG
GGCBBCBBGGGGBBBGBGGGGGGGGGGGGGGGGGBBGBBGGGGBBBGGGGGGGGGGGGGGGGGGGGGCCGCCBBBBBGGRGGGGGGGGGGCCGCGGGGGG
GGCBBBBGGGGGBBBGBGGGGGGGGGGGGGGGGGBBBBGCCGGBBBGBGGGGGGGGGGGGGGGGGGGCCCGCGGGRRGGRRGGGGGGGGCGCCCGGGGGG
GGGCCBCGGGGGGGGGGGGGGGGGGGGGGGGGGGBBGBGCCGGGGGGGGGGGGGGGGGGGGGGGGGGCGGCCGGGGRGRRRGGGCCCGGCGCCCGCCBCC
GGCBBBGBGGGGGGGGGGGGRGGGGGGGGGGGGGGGCCGGGCCCGGGGGGGGGGGGGGGGGGGGGCCCCCGCGGGGGGGGGGGGCCGGCGCCCBBCCGCG
GGCGGCGGGGGGGGGGGGGGRGRGGGGGGCGCCCGGGGCCCCCGCCGGGGGGGGGGGGGGGGGGGGCCGCGGGGRRGGGGGGGGCGCGCCCGCBBBCCGC
GGGGBBGBBGGGGGGGGCCCGRGGGGGGGCCCCCGGGCBBBCCCCCCCBBGBBGGGGGGGGGGGGGGCCCGGGGGGGGGGGGGGCGCCCGGGGBBBGCGC
GGGGBBBGGGGGGGGCCCCCGGGGGGGGGCCCCGGGGBBBGCCGCCCGCCBGBGGGGGGGGGGGGCCCCCGGGGRRGGGGGGGGGGCGCGGGGBGCBCGC
GGGGBGBBBGGGGGGCCCGCGBBBBBGGGGCGCGGGBBBBBGCGCCCCBGBBGGGGGGGGRRGGGCCGCCGGGGGGGGGGGGGGGGGGGGGGGGGGGGGG
GGGGBBGGBGGGGGGCGCCCGGBBBGGGGCCCGCGGBBGGGGGGGCGGBBBBBGGGGGGRRGGGGGGGGGGGGGGGGGGGGGGGGGGGGGGGGCCCGGGG
GGGGCCCCCGGGGGGCGCCCGBGBCCCCGGGGGGCCCBBBGGGGGCCCCBGBGGGGGGGGGGBGGBBGGGGGGGGGGGGGGGGGGGGGGGGCGGCCGGGG
GGGGGGCCCGGGGGGGGGGGGGBCCCGCGGGGGCCCGGGGGGGGGGGGRRGGGGGGGGGGGGGGBBGGGGCCCGGGGGGGGGGGGGGGGGGGCGGCGGGG
GGGGCCCGGGGGGGGGGGRGGBBCCCGCGGGGGCCCGCGGGGGGGGGRGGGGGGGGGGGGGGBBBBBGGCCCGGGGGGGGGGGGGGGGGGGCCCCCGGGG
GGGGGGGGGGGGGGGGGRGGGGGCBCCBBGGGGGCCGGGGGRRGGGGRGRCCCCCGGGGGGGGBGGBGGCCCGGGGGGGGGGGGGGGGGGGGGCCGGGGG
GGGGCCCCCBGBBBGGRGRGGGGGBGCBBGGGGGGGGCGGGGRGGGGGGGCGCCCGGGGGGGGGCBGCCCBBBGBGGGGGGBGBGGGGGGGGGGGGGGGG
GGGGGGGGGBBGBBRRGGGGGGGGBBBBGGGGGGGGGGGGGGGGGGGGGGCCCCCGGGGGGGGGCGGGCGGBBBBGBGBBBGBGGGGGGGGGGGGGGGGG
GGGGGGGGGBBBBBRRGGGGGGGGBBBBBGGGRGRGGGGGGGGGGGGGGGGCCCCGGGGGGGGGCCGCCGBGBGBBGGBBGBRBGGGBBBBGGGGGGCCG
GGGBBBBGGGGRBBRGGGGGGGGGGBBGBGGGRGGGGGGGGGGGGGGGGGCCGCGGGGGGGGGGGCGCCGGBBBBBGGGGBGGBGGGGGGBGGGGGCCCC
GGGGBBGBGBGBGBGGGGGGGGGGGGGGGGGGGGGGGGGGGGGGGGCCCGGGGGGCCCCGGGGGRRRGCGCCCBBBBBBBBRBGGGBBBBGGGGGGCCCC
GGGBGBGBGGGGGRGGGGGGGGGGGRGGGGGGGGGGGGGGGGGGCCCCCGGGGGGGCCCCGGGGRGRGCCCGGGGBGBGBGGGGGGBBBBBGGGGGCCGC
GGGBGGBBGGGGGGGGGGGGGGGGGRGGGGGGGGGGGGGGGGGGCCCGCGGGGGGCGCGCGGGGRGGGGGGCCGGGGGGGGGGGGRGBBBBGGGGGGGCC
GGGBBBBGGGBGGGGGGGGCGCCCGGGGGGGGGGGGGGGGGGGGGGGCCGBBBBGCCCGCGGGGGGGGRGCGCGGGGGRGGGGGRRGGGGGGGGGCCGGG
RRGGGGBBBGBGGGGGGGGCCCCCGGGGGGGCCCCCGGGGGGGGCCCCCGBBBBBCGCCGGGGGGGGGRCGGCGGGGGGGCCGCGGGGGGGGGGCCCCGG
GRGGGGBGBBBBBBBGGGGGGCCGGGGGGGGGCGCCGGGGGGGGGGGGGBBBBGGGGGGGGGGGGGGGRGGGRGRGGGGGCGCGCGGGGGGGGGCGCCGG
GGGGGGBBBBBGBBGGGGGGCGCCGGGGGGGCCGCCGGGGGGGGGGGGGGBBBBBGGCCCCGGGGGGGGGGGRRGGGGGGCCCCGGGGGGGGGGCCCCCG
GGGGGGBBBBBBBBBGGGGCCCCGGGGGGGGCGCCCGGGGGGGGGGGGGBGBBBBGGCGCGGGGGGGGGGGGGRGGGGGGGCCGGGGGGGGGGGGCGGCG
GGGGGGGGGGBBBBBGGGGGGGGGGGGGGGGCCCGCGGGGGGGGGGGGGBBBGGGGGCGCGCGGGGGGGGGGGGGGGGGGCGCCCCCGGGGGGGGGGGGG
GGGGGGGGGGBBBBBGGGGGGGGGGGGGGGGGGGRGGGGGGGGGGGGGGBGBBBGGGCCGCCGGGGGGGGGCCCCCGGGGGGCCCCCGGGGGGGGRRGGG
GGGGGGGGGGGGGGGGGGGGGGGGGGGGGGGGGRGGGGGGGGGGGGGGGGGGGGGGGCCCCCGGGGGGGGGCCGCCGGGGGGCCCCCGRGGGGGGGGGGG
GGGGGGGGCCGCCGGGGGGGGGGGGGGGGGGGGGGGGGGGGGGGGGGGGGGGGGGGGGGGGGGGGGGGGGGCGGGCGGGGGGGCCCCGGGGBBGGGRGGG
GGGGGGGGBGCBBGGGGGGGGGGCGCGGGGGGGGGGGGGGGGGGGGGGGGGGGGGGGGGGGGGGGGGGGGGGCGCCGGGGGGCCCRGGRBBBGBBGBGGG
GGGGGCCGCCCCCGGGGGGGGGCCCCCGBBGBBGGGGGGGGGGGGGGGGGGGGGGGGGGGGGGCCCCGGGGGCCCBBGGGGGGGRGRGGBBGGBBGBGGG
GGGGCGGCCGBBBGGGGGGGGGCCCGCGBGBBGGGGGGGGBBGBBGGGGGGGGGGGGGGGGGGCGCCCGGGGBBBBBGGGGGGGGRGGGBGGGBGBBBCC
GGGGCCCCCCBCBGGGGGGGGGCGCGCGBBBBBGGGGGGGGBGBGRGGGGGGGGGGGGGGGGGCGCCCGGGGBGGBBGGGGBBGGBGGRGBBBBGBBBGC
GGGGGCCCCBGBGCCCGGGRRRCCCGGGBGBBBGGGGGGGBGBBBGGGGGGGGGGGGGGGGGGCCGCGGGGGBGGCCCCGGBGBBBGGGRGGGGGGBBGC
GGGGCCCCCGGCGGCCGGGGRRGGGGGGGBBGGGGGGGGGBBBBBGGGGGGGGGGCCCGGGGGCGCCGGGGGGBGCCCGRGGBGBBGGGGGGGGGBBGCB
BGBCCGCCGGGCCCGCGGGGGGGGGGGGGGGGGGGGGGGGBBBBGGGGGGGGGGCGGGCGGGGGGGGGGGBGBBCCCCGGGBBBBBCCCGCGGGGBGBGB
GGBGGGCCGGGCCCGCGGGGGGGGGGGGGGGGGGGGGGGRRRCCCCGCCCGGGBCBCCCGGGGGBGGBBGBGGBBCCGGGGBBBBBCCGCCGGGGBGBGB
BBBCCCCRRRGCGCCCGGGGGGGGGGGGGGGGGGGGGGGGGRGCGCCCGGGBBBGGCCCGGGGGBBBBBGBBBBCCGCGGGBGGBBCCCGCGGGGBBBBB
BGBGCCGCGGGGGGGGGGGGGGGGGGGGGGGGGGGGGGGGGRCGCCCCCCGBGGGCGGCGGGGGBBBBBGGBBGBGGGGGGBBBBBBBBCGGGGGGGBGB
